United-Arab-Emirates=AE
El-Salvador=SV
Mauritius=MU
Ethiopia=ET
Dominica=DM
Northern-Mariana-Islands=MP
Sweden=SE
Guinea-Bissau=GW
Gabon=GA
United-States=US
Nauru=NR
Guatemala=GT
Palestine=PS
Kyrgyzstan=KG
Angola=AO
Namibia=NA
Cayman-Islands=KY
Antarctica=AQ
Spain=ES
Wales=_wales
Denmark=DK
Myanmar=MM
Vanuatu=VU
Austria=AT
Pitcairn-Islands=PN
Barbados=BB
Azerbaijan=AZ
Slovenia=SI
Martinique=MQ
Cuba=CU
Basque-Country=_basque_country
Albania=AL
Nepal=NP
Mauritania=MR
NATO=_nato
Antigua-and-Barbuda=AG
Eritrea=ER
Tuvalu=TV
Ukraine=UA
Brunei=BN
Cocos-Keeling-Islands=CC
United-Kingdom=GB
Zambia=ZM
Bhutan=BT
Montenegro=ME
Uzbekistan=UZ
Dominican-Republic=DO
Guam=GU
Iceland=IS
Ireland=IE
France=FR
Norway=NO
Montserrat=MS
Tunisia=TN
Macedonia=MK
Micronesia=FM
Anguilla=AI
Tanzania=TZ
Swaziland=SZ
Kenya=KE
Italy=IT
Western-Sahara=EH
Olympics=_olympics
Brazil=BR
Cameroon=CM
Central-African-Republic=CF
Croatia=HR
Hong-Kong=HK
Turkmenistan=TM
Commonwealth=_commonwealth
Saint-Helena=SH
Northern-Cyprus=_northern_cyprus
Uruguay=UY
Burundi=BI
Botswana=BW
Colombia=CO
Republic-of-the-Congo=CG
Bahamas=BS
Saint-Martin=MF
Germany=DE
Serbia=RS
Estonia=EE
Georgia=GE
England=_england
Bahrain=BH
Kazakhstan=KZ
Venezuela=VE
South-Africa=ZA
Fiji=FJ
Netherlands=NL
French-Southern-Territories=TF
Latvia=LV
Wallis-And-Futuna=WF
Vietnam=VN
Turks-and-Caicos-Islands=TC
Marshall-Islands=MH
Mars=_mars
Burkina-Faso=BF
United-Nations=_united_nations
Sierra-Leone=SL
South-Korea=KR
Cote-dIvoire=CI
Nigeria=NG
Niger=NE
Saudi-Arabia=SA
Scotland=_scotland
Jersey=JE
Belgium=BE
Bolivia=BO
Iraq=IQ
Senegal=SN
Canada=CA
Costa-Rica=CR
Benin=BJ
Comoros=KM
Trinidad-and-Tobago=TT
Egypt=EG
European-Union=EU
Mexico=MX
Greenland=GL
India=IN
Madagascar=MG
South-Georgia-and-the-South-Sandwich-Islands=GS
Lebanon=LB
Andorra=AD
Rwanda=RW
Ecuador=EC
Syria=SY
Guernsey=GG
US-Virgin-Islands=VI
New-Zealand=NZ
Aland=AX
Romania=RO
Bulgaria=BG
Taiwan=TW
Jordan=JO
Somalia=SO
Japan=JP
Sri-Lanka=LK
Chad=TD
Unknown=_unknown
Kuwait=KW
Mongolia=MN
Panama=PA
Mozambique=MZ
Liberia=LR
Macau=MO
Israel=IL
Malawi=MW
Uganda=UG
Cook-Islands=CK
Portugal=PT
Nagorno-Karabakh=_nagorno_karabakh
East-Timor=TL
Cape-Verde=CV
South-Ossetia=_south_ossetia
Norfolk-Island=NF
Australia=AU
Belarus=BY
Sudan=SD
Equatorial-Guinea=GQ
Slovakia=SK
Somaliland=_somaliland
Philippines=PH
Isle-of-Man=IM
Thailand=TH
Qatar=QA
Guyana=GY
Turkey=TR
Democratic-Republic-of-the-Congo=CD
Nicaragua=NI
Ghana=GH
Libya=LY
Malta=MT
Laos=LA
Tajikistan=TJ
Chile=CL
Hungary=HU
GoSquared=_gosquared
Algeria=DZ
Monaco=MC
Finland=FI
Poland=PL
Iran=IR
Afghanistan=AF
Argentina=AR
New-Caledonia=NC
Canary-Islands=IC
Tonga=TO
Kiribati=KI
Palau=PW
North-Korea=KP
Samoa=WS
Curacao=CW
Jamaica=JM
Indonesia=ID
Greece=GR
British-Antarctic-Territory=_british_antarctic_territory
China=CN
Maldives=MV
Gambia=GM
South-Sudan=SS
Cambodia=KH
Abkhazia=_abkhazia
American-Samoa=AS
Belize=BZ
Bangladesh=BD
Switzerland=CH
Morocco=MA
Kosovo=_kosovo
Paraguay=PY
Saint-Lucia=LC
Luxembourg=LU
Red-Cross=_red_cross
Bosnia-and-Herzegovina=BA
Aruba=AW
Seychelles=SC
Christmas-Island=CX
Grenada=GD
Lithuania=LT
Papua-New-Guinea=PG
Cyprus=CY
Armenia=AM
Gibraltar=GI
Mayotte=YT
French-Polynesia=PF
Togo=TG
Falkland-Islands=FK
Faroes=FO
Saint-Kitts-and-Nevis=KN
Haiti=HT
British-Virgin-Islands=VG
Russia=RU
Pakistan=PK
Mali=ML
Moldova=MD
Bermuda=BM
Czech-Republic=CZ
Guinea=GN
Honduras=HN
Niue=NU
Oman=OM
Tokelau=TK
Netherlands-Antilles=AN
Lesotho=LS
Suriname=SR
Sao-Tome-and-Principe=ST
Zimbabwe=ZW
Peru=PE
Vatican-City=VA
Solomon-Islands=SB
Yemen=YE
Saint-Vincent-and-the-Grenadines=VC
Singapore=SG
Djibouti=DJ
Liechtenstein=LI
Malaysia=MY
San-Marino=SM
Saint-Barthelemy=BL
Puerto-Rico=PR